################################################################
################################################################
################################################################
################################################################
################################################################
################################################################
################################################################
################################################################
################################################################
################################################################
################################################################
################################################################
################################################################
################################################################
################################################################
#########################           ############################
#########################     !     ############################
#########################           ############################
######################### m       m ############################
#########################           ############################
#########################           ############################
#############################   ################################
#############################   ################################
##############################-#################################
#############################   ################################
#############################   ################################
###################W                        ####################
###################                      W+ ####################
###################     W                   ####################
#############################   ################################
#############################   ################################
#############################   ################################
#############################   ################################
###########################       ##############################
###########################       ##############################
###########################       ##############################
###########################   @   ##############################
###########################       ##############################
###########################       ##############################
###########################       ##############################
################################################################
################################################################
################################################################
################################################################
################################################################
################################################################
################################################################
################################################################
################################################################
################################################################
################################################################
################################################################
################################################################
################################################################
################################################################
################################################################
################################################################
################################################################
################################################################
################################################################
################################################################
################################################################
################################################################
################################################################