################################################################
################################################################
################################################################
################################################################
################################################################
################################################################
################################################################
################################################################
################################################################
################################################################
################################################################
################################################################
################################################################
################################################################
################################################################
################################################################
#############################      T      ######################
#############################             ######################
#############################             ######################
#############################   #######   ######################
#########       #############   #######   ######################
#########       #############   #######   ######################
#########              w                  ######################
#########   !  |                          ######################
#########           w                     ######################
#########       #############   ################################
#########       #############   ################################
#############################   ################################
#############################   ################################
#####################                m  ########################
#####################                   ########################
#####################  m      *         ########################
#####################                   ########################
#####################                W  ########################
#####################                   ########################
#####################                   ########################
###########################   @   ##############################
###########################       ##############################
###########################       ##############################
###########################       ##############################
################################################################
################################################################
################################################################
################################################################
################################################################
################################################################
################################################################
################################################################
################################################################
################################################################
################################################################
################################################################
################################################################
################################################################
################################################################
################################################################
################################################################
################################################################
################################################################
################################################################
################################################################
################################################################
################################################################
################################################################